|----------------|
|p               |
|                |
|                |
|                |
|                |
|                |
|                |
|                |
|                |
|                |
|                |
|                |
|                |
|                |
|e---------------|
up
down
left
right
#
#
#
#
#
#


