|--------------|
|              |
|              |
|              |
|              |
|              |
|              |
|              |
|              |
|       p      |
|              |
|              |
|              |
|              |
|              |
|-------e------|
down
#
#
#
#
#
#
