|----------------|
|                |
|                |
|                |
|                |
|                |
|                |
|                |
|        |       |
|        |       |
|        |       |
|        |       |
|        |       |
|        |       |
|p       |       |
|------------e---|
right
down
up
down
#
#
#
#
#


