|--------------|
|              |
|              |
|              |
|              |
|              |
|              |
|              |
|              |
|              |
|              |
|              |
|              |
|              |
e     p        |
|--------------|
right
#
#
#
#
u-turn
u-turn
