|----------------|
|               p|
|                |
|                |
|                |
|                |
|                |
|                |
|                |
|                |
|                |
|                |
|                |
|                |
e                |
|----------------|
up
down
left
#
#
#
#
#
#


