|--------------|
|              |
|              |
|              |
|              |
|       l      |
|              |
|              |
|              |
|       p      |
|              |
|              |
|              |
|-------d------|
|              |
|-------e------|
down
up
#
#
#
#
#
#
