|--------------|
|              |
|              |
|              |
|              |
| [     {      |
|              |
|              |
|              |
|       p      |
|              |
|              |
|              |
|-]-----}---}--|
|              |
|-------e------|
down
up
#
#
#
#
#
#
