|--------------|
|              |
|              |
|              |
|              |
|              |
|              |
|      |       |
|      |       |
|  p   |       |
|      --------|
|              |
|              |
|------|       |
|      |       |
|----------e---|
right
down
#
#
#
#
#
#
teleportA
teleportB
