|--------------|
|              |
|              |
|              |
|      p       |
|              |
|              |
|              |
|              |
|              |
|--------------|
|              |
|              |
|------|       |
|      |       |
|----------e---|
down
#
#
#
#
#
#
teleportA
teleportB
